...###
..#..#.####
.#....#...#
#.........#
#...@..#..#
#....#.#..#
.#...#....#
.#...#....#
.#.......#
.#......#
.#......#